# Halo 1 tag types

actr = actor
actv = actor_variant
ant! = antenna
bipd = biped
bitm = bitmap
trak = camera_track
colo = color_table
cdmg = continuous_damage_effect
cont = contrail
jpt! = damage_effect
deca = decal
udlg = dialogue
dobc = detail_object_collection
devi = device
ctrl = device_control
lifi = device_light_fixture
mach = device_machine
effe = effect
eqip = equipment
flag = flag
fog  = fog
font = font
garb = garbage
mod2 = gbxmodel
matg = globals
glw! = glow
grhi = grenade_hud_interface
hudg = hud_globals
hmt  = hud_message_text
hud# = hud_number
devc = input_device_defaults
item = item
itmc = item_collection
lens = lens_flare
ligh = light
mgs2 = light_volume
elec = lightning
foot = material_effects
metr = meter
mode = model
antr = model_animations
coll = model_collision_geometry
mply = multiplayer_scenario_description
obje = object
part = particle
pctl = particle_system
phys = physics
plac = placeholder
pphy = point_physics
ngpr = preferences_network_game
proj = projectile
scnr = scenario
sbsp = scenario_structure_bsp
scen = scenery
snd! = sound
snde = sound_environment
lsnd = sound_looping
ssce = sound_scenery
boom = spheroid
shdr = shader
schi = shader_transparent_chicago
scex = shader_transparent_chicago_extended
sotr = shader_transparent_generic
senv = shader_environment
sgla = shader_transparent_glass
smet = shader_transparent_meter
soso = shader_model
spla = shader_transparent_plasma
swat = shader_transparent_water
sky  = sky
str# = string_list
tagc = tag_collection
Soul = ui_widget_collection
DeLa = ui_widget_definition
ustr = unicode_string_list
unit = unit
unhi = unit_hud_interface
vehi = vehicle
vcky = virtual_keyboard
weap = weapon
wphi = weapon_hud_interface
rain = weather_particle_system
wind = wind

# Open Sauce tag types
avti = actor_variant_transform_in
avto = actor_variant_transform_out
avtc = actor_variant_transform_collection
efpp = effect_postprocess
efpc = effect_postprocess_collection
efpg = effect_postprocess_generic
eqhi = equipment_hud_interface
magy = model_animations_yelo
unic = multilingual_unicode_string_list
yelo = project_yellow
gelo = project_yellow_globals
gelc = project_yellow_globals_cv
shpp = shader_postprocess
shpg = shader_postprocess_generic
sppg = shader_postprocess_globals
sidy = string_id_yelo
tag+ = tag_database
sily = text_value_pair_definition