# Halo 2 tag types

adlg = ai_dialogue_globals
mdlg = ai_mission_dialogue
ant! = antenna
bipd = biped
bitm = bitmap
bsdt = breakable_surface
$#!+ = cache_file_sound
trak = camera_track
devo = cellular_automata
whip = cellular_automata2d
char = character
gldf = chocolate_mountain
clwd = cloth
coll = collision_model
coln = colony
colo = color_table
cont = contrail
bloc = crate
crea = creature
jpt! = damage_effect
deca = decal
DECR = decorator_set
DECP = decorators
dobc = detail_object_collection
devi = device
ctrl = device_control
lifi = device_light_fixture
mach = device_machine
udlg = dialogue
effe = effect
eqip = equipment
garb = garbage
matg = globals
grhi = grenade_hud_interface
hudg = hud_globals
hmt  = hud_message_text
hud# = hud_number
item = item
itmc = item_collection
lens = lens_flare
ligh = light
MGS2 = light_volume
tdtl = liquid
foot = material_effects
mpdt = material_physics
metr = meter
hlmt = model
jmad = model_animation_graph
mcsr = mouse_cursor_definition
unic = multilingual_unicode_string_list
mulg = multiplayer_globals
mply = multiplayer_scenario_description
goof = multiplayer_variant_settings_interface_definition
nhdt = new_hud_definition
obje = object
prt3 = particle
PRTM = particle_model
pmov = particle_physics
fpch = patchy_fog
phys = physics
phmo = physics_model
pixl = pixel_shader
fog  = planar_fog
pphy = point_physics
proj = projectile
mode = render_model
sbsp = scenario_structure_bsp
ltmp = scenario_structure_lightmap
scnr = scenario
ai** = scenario_ai_resource
*ipd = scenario_bipeds_resource
cin* = scenario_cinematics_resource
clu* = scenario_cluster_data_resource
/**/ = scenario_comments_resource
*rea = scenario_creature_resource
dec* = scenario_decals_resource
dc*s = scenario_decorators_resource
dgr* = scenario_devices_resource
*qip = scenario_equipment_resource
hsc* = scenario_hs_source_file
*cen = scenario_scenery_resource
*sce = scenario_sound_scenery_resource
sslt = scenario_structure_lighting_resource
*igh = scenario_lights_resource
trg* = scenario_trigger_volumes_resource
*ehi = scenario_vehicles_resource
*eap = scenario_weapons_resource
scen = scenery
egor = screen_effect
shad = shader
stem = shader_template
slit = shader_light_response
spas = shader_pass
sky  = sky
snd! = sound
ugh! = sound_cache_file_gestalt
sncl = sound_classes
spk! = sound_dialogue_constants
<fx> = sound_effect_template
sfx+ = sound_effect_collection
snde = sound_environment
lsnd = sound_looping
snmx = sound_mix
ssce = sound_scenery
BooM = stereo_system
styl = style
sily = text_value_pair_definition
unit = unit
unhi = unit_hud_interface
wgtz = user_interface_globals_definition
skin = user_interface_list_skin_definition
wgit = user_interface_screen_widget_definition
wigl = user_interface_shared_globals_definition
vehi = vehicle
vehc = vehicle_collection
vrtx = vertex_shader
weap = weapon
wphi = weapon_hud_interface
weat = weather_system
wind = wind